%%%%%%%%%%%%%%%%%%%%%%%%%%%%%%%%%%%%%%%%%%%%%%%%%%%%%%%%%%%%%%%
%     %     %     %     %     %     %                         %
%  %  %  %  %  %  %  %  %  %  %  %  %  %                      %
%. %     %     %     %     %     %     %                     P%
%%%%%%%%%%%%%%%%%%%%%%%%%%%%%%%%%%%%%%%%%%%%%%%%%%%%%%%%%%%%%%%